13 13
300 9
B______R_____
_OOOO____R__
_____________
____R________
_________R___
_____________
_____________
_R______R____
_____________
R___OOOOO____
_____________
___R_________
___________R_