13 13
250 9 120
B______R_____
__________R__
_________R___
___O_O_O_O___
____R________
____O_O_OR___
S____________
___O_O_O_O___
_R______R____
_____________
R____________
_____________
___R_________
