13 13
450 9 120
B______R_____
__OOOO____R__
_OOOO____R___
_____________
____R________
_________R___
_____________
_____________
_R______R____
_____________
R___OOOOO____
_____________
___R_________
