11 11
400 5
___________
_____B_____
__OOOOOOO__
__O_____O__
__O__R__O__
__O_RRR_O__
__O__R__O__
__O_____O___
__OOOOOOO__
___________
___________