13 13
100 9 60
_______R_____
__OOOO____R__
_____________
____R________
_________R___
____B_S______
_____________
_R___________
___________R_
R____OOOOO___
_____________
___R_________
___________R_