13 13
300 9
_______R_____
__OOOO____R__
_____________
____R________
_________R___
____B________
_____________
_R___________
___________R_
R____OOOOO___
_____________
___R_________
___________R_